tag	clust_5	clust_6
circles	Social-Emotional Learning & Equity	Equity
community_support	Social-Emotional Learning & Equity	Equity
poverty_supports	Social-Emotional Learning & Equity	Equity
culturally_relevant	Social-Emotional Learning & Equity	Equity
wraparound	Social-Emotional Learning & Equity	General Approaches
restorative_practice	Social-Emotional Learning & Equity	Equity
sel_plan	Social-Emotional Learning & Equity	General Approaches
sel_integrated	Social-Emotional Learning & Equity	Equity
sel	Social-Emotional Learning & Equity	General Approaches
immigrants_supports	Social-Emotional Learning & Equity	Equity
mental_health	Social-Emotional Learning & Equity	Equity
measures_sel	Social-Emotional Learning & Equity	General Approaches
measures_climate	Social-Emotional Learning & Equity	General Approaches
ell_supports	Social-Emotional Learning & Equity	Equity
reallocation_resources	Social-Emotional Learning & Equity	Equity
equity_plan	Social-Emotional Learning & Equity	Equity
physical_health	Social-Emotional Learning & Equity	Equity
hiring_practices	Social-Emotional Learning & Equity	Equity
sel_curriculum	Social-Emotional Learning & Equity	Equity
equity	Social-Emotional Learning & Equity	General Approaches
open_hours	Social-Emotional Learning & Equity	Equity
measures_purpose	Social-Emotional Learning & Equity	Assessment & Student Success
design_margins	Social-Emotional Learning & Equity	General Approaches
projects_primary	Project-Based Learning	Project-Based Learning
interdisciplinary	Project-Based Learning	Project-Based Learning
local_global	Project-Based Learning	Project-Based Learning
design_thinking	Project-Based Learning	Project-Based Learning
service_learning	Project-Based Learning	Project-Based Learning
exhibitions	Project-Based Learning	Project-Based Learning
real_world	Project-Based Learning	Project-Based Learning
student_projects	Project-Based Learning	Project-Based Learning
pbl	Project-Based Learning	Project-Based Learning
portfolios	Project-Based Learning	Project-Based Learning
maker	Project-Based Learning	Project-Based Learning
experiential	Project-Based Learning	Flexible Pathways to College & Career
local_focus	Project-Based Learning	Project-Based Learning
measures_deeper	Project-Based Learning	Project-Based Learning
flexible_facilities	Project-Based Learning	Blended Learning
ways_mastery	Project-Based Learning	Assessment & Student Success
student_conferences	Project-Based Learning	Project-Based Learning
makerspace	Project-Based Learning	General Approaches
flexible_staffing	Project-Based Learning	Project-Based Learning
relevant_learning	Project-Based Learning	Assessment & Student Success
oer	Project-Based Learning	Blended Learning
career_prep	Flexible Pathways to College & Career	Flexible Pathways to College & Career
graduation_supports	Flexible Pathways to College & Career	Flexible Pathways to College & Career
measures_college	Flexible Pathways to College & Career	Flexible Pathways to College & Career
outside_credit	Flexible Pathways to College & Career	Flexible Pathways to College & Career
community_partnerships	Flexible Pathways to College & Career	Flexible Pathways to College & Career
devices_home	Flexible Pathways to College & Career	Flexible Pathways to College & Career
multi_age	Flexible Pathways to College & Career	Flexible Pathways to College & Career
learning_paths	Flexible Pathways to College & Career	Flexible Pathways to College & Career
measures_career	Flexible Pathways to College & Career	Flexible Pathways to College & Career
advisories	Flexible Pathways to College & Career	Flexible Pathways to College & Career
elimination_tracking	Flexible Pathways to College & Career	Flexible Pathways to College & Career
mentoring	Flexible Pathways to College & Career	Flexible Pathways to College & Career
a_la_carte	Flexible Pathways to College & Career	Flexible Pathways to College & Career
information_formats	Flexible Pathways to College & Career	Flexible Pathways to College & Career
enriched_virtual	Flexible Pathways to College & Career	Flexible Pathways to College & Career
rigorous_coursework	Flexible Pathways to College & Career	General Approaches
learner_profiles	Flexible Pathways to College & Career	Blended Learning
staffing_infrastructure	Flexible Pathways to College & Career	General Approaches
competency_education	Assessment & Student Success	Assessment & Student Success
grading_mastery	Assessment & Student Success	Assessment & Student Success
learner_agency	Assessment & Student Success	General Approaches
assessment_schedule	Assessment & Student Success	Assessment & Student Success
competency_framework	Assessment & Student Success	Assessment & Student Success
advancement_mastery	Assessment & Student Success	Assessment & Student Success
opportunities_mastery	Assessment & Student Success	Assessment & Student Success
performance_assessment	Assessment & Student Success	Assessment & Student Success
redefining_success	Assessment & Student Success	General Approaches
student_pace	Assessment & Student Success	Blended Learning
student_goals	Assessment & Student Success	Assessment & Student Success
flexible_schedule	Assessment & Student Success	Flexible Pathways to College & Career
udl	Assessment & Student Success	General Approaches
station_rotation	Blended Learning	Blended Learning
real_time_data	Blended Learning	Blended Learning
data_instruction	Blended Learning	Blended Learning
individual_rotation	Blended Learning	Blended Learning
lab_rotation	Blended Learning	Blended Learning
blended_learning	Blended Learning	Blended Learning
integrated_data	Blended Learning	Blended Learning
adaptive_content	Blended Learning	Blended Learning
flipped_classroom	Blended Learning	Blended Learning
flex	Blended Learning	Blended Learning
student_data	Blended Learning	Blended Learning
accommodations	Blended Learning	Assessment & Student Success
quality_materials	Blended Learning	Equity
